111111111111111
wwwwwwwwwwwwwww
w000bb00000000w
w0wbwbwbwbwbwbw
w0bbbbbbbbbbbbw
wbwbwbwbwbwbwbw
wb000000000000w
w0w0w0w0w0w0w0w
w0000000000000w
w0w0w0w0w0w0w0w
w0000000000000w
w0w0w0w0w0w0w0w
w0000000000000w
w0w0w0w0w0wbwbw
w00000000bbbb0w
wwwwwwwwwwwwwww